---CCCCCCC----
---CCCCCCC----
0000-----000--
000-------00--
000-------00--
0S0--0000CCCCC
000--0000CCCCC
-----0T0--CC0C
-----000--CCCC