-P--------000
P0P--XX0--0T0
-P--------000
-------------
-------------
--000---000--
--0S00000P0--
--000---000--