------0000--000
0000--00O0--0T0
00O0--0000--000
0000--0000--000
0S00--0000--000
0000--0000-----