--------0000---
--------0000---
000-----0--0000
0S0000000---0T0
000----00X--000
000----000--000
-00----0-------
--000000-------