-000000--------
-00--000-------
CCS--0000------
CC-----000-----
CC------000----
C000-----00P---
-0T0------00000
-000000---0O000
--0--00---000--
--0--00000000--