------------000
--00000000--000
--000--OS0--000
--000--000-----
--0O0--P0O-----
--000--000-----
0000---000--O00
0O----------000
------------0T0
------------000