-------O-------
00O0---0-------
00000--0-------
0OS00000--00--0
00000---0---0--
00O0----0---0--
0-------O--000-
0---------00T0-
0--X------0000-