000-----000000
0T0--0--0S00P0
000-----0000--
---------000--
-----------00-
------------0-
------------0-
-----------00-
----00000--00-
----0O--000X0-