-----------0000
-0000000O0000S0
-0000-------000
-00O0----------
-0000----------
---000O000000--
----------0000O
000-------00000
0T00000000000--
0000-----------