000----00000000
0S000000000--00
000----00----00
------------0X0
------------00-
000--CCCC0--OO-
0T0CCCCCCC--000
000CCCCCCCCC000
-----CCCCCCC000
------0000-----