000C0000C0000-
00--------000-
00---------000
000---000--0S0
000CCC0T0--000
000--C000--0--
--0--CCCCC00--
--000CC0CCC---
---00CCCCCC---
---000--00----