-----------000-
-000----X--0T0-
-00000000--000-
-000--000---0--
-CCC--O00---C--
--C---000--CCC-
--0---000--000-
0000--0O0000S0-
00X0--X----000-
0000-----------