0000---0---0000
0S00---0---00P0
000000000000000
------0T0------
------000------