-----00----000
---000000--0T0
000000O0000000
0S00O--00000--
000------000--
-0--------0---
-0--------0---
-0-------00---
-00------00---
--X------X----