----------0000
----0000000X0P
-S--0X0---0000
X0--00------0-
00--0-------0-
00000-----000-
000--000--0T0-
-----X0---000-