--------00-----
-------000-----
00--000000-----
0S0000--0------
0000----0---000
-00-----X0000T0
--0-----X0--000
--000---00-----
---000--00-----
----000000-----