--00----------
--000---------
--00O-----000-
---0000---0T0-
------00--000-
-00---00------
00X00000------
0S0---00---000
000---00O00000
-----------000