-S00000000O0000
-----00------00
-----00------00
-------------00
-------------00
000--00--0O0000
0T0--00--------
000--00--------
-00--00--------
-000000000O000-