-----0000----P
-----00O000--0
----0000000--0
00000000--0000
000---0---00--
000---0---S---
-0----000-----
-X----0T0-----
------000-----