-000--------000
-0X0--------0O0
-000---00000000
-000---0T0--00O
0---0--000----0
O---0--CCC----0
0--000CCCCC0000
---0S0CCCCC0P0-
---000CCCCC000-
---00000-------