------------X
-----000--000
-----0X00000-
---00000--00-
---0T0----00-
-00000---0000
00S0-----0000
0000--00000--
-----000-----
-----000-----