000------------
0S0000000---000
000-----00000T0
000---------XX0
000------------
000------------
000----00000X--
00000000---00--
0O0--------00--
000--------0X--