-----000000----
-----0--000----
-----0--00000--
S00000-----0000
----000----00T0
----000-----000
------0--00----
------00000----
------00000----
-------000-----