--O000---0--X--
-----0---0-----
-----00000-----
X--0000S0000--X
-----00000-----
------0--0-----
------0--000O--
000--00--0-----
0T0--0---0-----
000------000O--