--------000---
--------000---
--------000---
000000--000000
0S00P0--0000T0
000000--000000
--------000---
--------000---
--------000---