---00000CC0000-
---0T00-----C0-
---000------C0X
-------C0000000
--S----CC-----0
-X0C---CC-----0
CCCC---00----00
CCC0C0CC0C--X0-
0CCCCCCCCCCC0--
-C0CCC--CCCC0--