-0000-------
-0T00-------
-000--------
-0---000000-
-0---00--00-
S000000--000
-----0O----0
-----0000--0
-----0000000
--------000-