-------000--000
----000000--X00
00--0--000--000
00000---O------
00-------------
-0-----P-------
-0-----0-------
000---000--O00-
0S0000000000T0-
000---000--O00-
