--------000---
---000--000---
0--0S000000000
0--000------X0
0-----------00
0-----------00
0-------000000
00000---000---
-00T0---000---
--000---00000X