Algorithm: GA
Time Consuming: 0.31999897956848145 Secs
Memory Consuming: 14.6875 MB

STEP 0
    Block Positions: p1: [1,3], p2: [1,3]
    Block Control: None
    Move: None

	0 0 0 0 0 0 1 1 1 1 1 1 1 0 0 
	1 1 1 1 0 0 1 1 1 0 0 1 1 0 0 
	1 1 1 1 1 1 1 1 1 0 0 1 1 1 1 
	1 1 1 1 0 0 0 0 0 0 0 1 1 1 1 
	1 1 1 1 0 0 0 0 0 0 0 1 1 1 1 
	0 0 0 0 0 0 0 0 0 0 0 0 1 1 1 
====================================

STEP 1
    Block Positions: p1: [1,1], p2: [1,2]
    Block Control: None
    Move: Move.Up

	0 0 0 0 0 0 1 1 1 1 1 1 1 0 0 
	1 1 1 1 0 0 1 1 1 0 0 1 1 0 0 
	1 1 1 1 1 1 1 1 1 0 0 1 1 1 1 
	1 1 1 1 0 0 0 0 0 0 0 1 1 1 1 
	1 1 1 1 0 0 0 0 0 0 0 1 1 1 1 
	0 0 0 0 0 0 0 0 0 0 0 0 1 1 1 
====================================

STEP 2
    Block Positions: p1: [0,1], p2: [0,2]
    Block Control: None
    Move: Move.Left

	0 0 0 0 0 0 1 1 1 1 1 1 1 0 0 
	1 1 1 1 0 0 1 1 1 0 0 1 1 0 0 
	1 1 1 1 1 1 1 1 1 0 0 1 1 1 1 
	1 1 1 1 0 0 0 0 0 0 0 1 1 1 1 
	1 1 1 1 0 0 0 0 0 0 0 1 1 1 1 
	0 0 0 0 0 0 0 0 0 0 0 0 1 1 1 
====================================

STEP 3
    Block Positions: p1: [0,3], p2: [0,3]
    Block Control: None
    Move: Move.Down

	0 0 0 0 0 0 1 1 1 1 1 1 1 0 0 
	1 1 1 1 0 0 1 1 1 0 0 1 1 0 0 
	1 1 1 1 1 1 1 1 1 0 0 1 1 1 1 
	1 1 1 1 0 0 0 0 0 0 0 1 1 1 1 
	1 1 1 1 0 0 0 0 0 0 0 1 1 1 1 
	0 0 0 0 0 0 0 0 0 0 0 0 1 1 1 
====================================

STEP 4
    Block Positions: p1: [1,3], p2: [2,3]
    Block Control: None
    Move: Move.Right

	0 0 0 0 0 0 1 1 1 1 1 1 1 0 0 
	1 1 1 1 0 0 1 1 1 0 0 1 1 0 0 
	1 1 1 1 1 1 1 1 1 0 0 1 1 1 1 
	1 1 1 1 0 0 0 0 0 0 0 1 1 1 1 
	1 1 1 1 0 0 0 0 0 0 0 1 1 1 1 
	0 0 0 0 0 0 0 0 0 0 0 0 1 1 1 
====================================

STEP 5
    Block Positions: p1: [1,2], p2: [2,2]
    Block Control: None
    Move: Move.Up

	0 0 0 0 0 0 1 1 1 1 1 1 1 0 0 
	1 1 1 1 0 0 1 1 1 0 0 1 1 0 0 
	1 1 1 1 1 1 1 1 1 0 0 1 1 1 1 
	1 1 1 1 0 0 0 0 0 0 0 1 1 1 1 
	1 1 1 1 0 0 0 0 0 0 0 1 1 1 1 
	0 0 0 0 0 0 0 0 0 0 0 0 1 1 1 
====================================

STEP 6
    Block Positions: p1: [3,2], p2: [3,2]
    Block Control: None
    Move: Move.Right

	0 0 0 0 0 0 1 1 1 1 1 1 1 0 0 
	1 1 1 1 0 0 1 1 1 0 0 1 1 0 0 
	1 1 1 1 1 1 1 1 1 0 0 1 1 1 1 
	1 1 1 1 0 0 0 0 0 0 0 1 1 1 1 
	1 1 1 1 0 0 0 0 0 0 0 1 1 1 1 
	0 0 0 0 0 0 0 0 0 0 0 0 1 1 1 
====================================

STEP 7
    Block Positions: p1: [4,2], p2: [5,2]
    Block Control: None
    Move: Move.Right

	0 0 0 0 0 0 1 1 1 1 1 1 1 0 0 
	1 1 1 1 0 0 1 1 1 0 0 1 1 0 0 
	1 1 1 1 1 1 1 1 1 0 0 1 1 1 1 
	1 1 1 1 0 0 0 0 0 0 0 1 1 1 1 
	1 1 1 1 0 0 0 0 0 0 0 1 1 1 1 
	0 0 0 0 0 0 0 0 0 0 0 0 1 1 1 
====================================

STEP 8
    Block Positions: p1: [6,2], p2: [6,2]
    Block Control: None
    Move: Move.Right

	0 0 0 0 0 0 1 1 1 1 1 1 1 0 0 
	1 1 1 1 0 0 1 1 1 0 0 1 1 0 0 
	1 1 1 1 1 1 1 1 1 0 0 1 1 1 1 
	1 1 1 1 0 0 0 0 0 0 0 1 1 1 1 
	1 1 1 1 0 0 0 0 0 0 0 1 1 1 1 
	0 0 0 0 0 0 0 0 0 0 0 0 1 1 1 
====================================

STEP 9
    Block Positions: p1: [7,2], p2: [8,2]
    Block Control: None
    Move: Move.Right

	0 0 0 0 0 0 1 1 1 1 1 1 1 0 0 
	1 1 1 1 0 0 1 1 1 0 0 1 1 0 0 
	1 1 1 1 1 1 1 1 1 0 0 1 1 1 1 
	1 1 1 1 0 0 0 0 0 0 0 1 1 1 1 
	1 1 1 1 0 0 0 0 0 0 0 1 1 1 1 
	0 0 0 0 0 0 0 0 0 0 0 0 1 1 1 
====================================

STEP 10
    Block Positions: p1: [7,1], p2: [8,1]
    Block Control: None
    Move: Move.Up

	0 0 0 0 0 0 1 1 1 1 1 1 1 0 0 
	1 1 1 1 0 0 1 1 1 0 0 1 1 0 0 
	1 1 1 1 1 1 1 1 1 0 0 1 1 1 1 
	1 1 1 1 0 0 0 0 0 0 0 1 1 1 1 
	1 1 1 1 0 0 0 0 0 0 0 1 1 1 1 
	0 0 0 0 0 0 0 0 0 0 0 0 1 1 1 
====================================

STEP 11
    Block Positions: p1: [7,0], p2: [8,0]
    Block Control: None
    Move: Move.Up

	0 0 0 0 0 0 1 1 1 1 1 1 1 0 0 
	1 1 1 1 0 0 1 1 1 0 0 1 1 0 0 
	1 1 1 1 1 1 1 1 1 0 0 1 1 1 1 
	1 1 1 1 0 0 0 0 0 0 0 1 1 1 1 
	1 1 1 1 0 0 0 0 0 0 0 1 1 1 1 
	0 0 0 0 0 0 0 0 0 0 0 0 1 1 1 
====================================

STEP 12
    Block Positions: p1: [9,0], p2: [9,0]
    Block Control: None
    Move: Move.Right

	0 0 0 0 0 0 1 1 1 1 1 1 1 0 0 
	1 1 1 1 0 0 1 1 1 0 0 1 1 0 0 
	1 1 1 1 1 1 1 1 1 0 0 1 1 1 1 
	1 1 1 1 0 0 0 0 0 0 0 1 1 1 1 
	1 1 1 1 0 0 0 0 0 0 0 1 1 1 1 
	0 0 0 0 0 0 0 0 0 0 0 0 1 1 1 
====================================

STEP 13
    Block Positions: p1: [10,0], p2: [11,0]
    Block Control: None
    Move: Move.Right

	0 0 0 0 0 0 1 1 1 1 1 1 1 0 0 
	1 1 1 1 0 0 1 1 1 0 0 1 1 0 0 
	1 1 1 1 1 1 1 1 1 0 0 1 1 1 1 
	1 1 1 1 0 0 0 0 0 0 0 1 1 1 1 
	1 1 1 1 0 0 0 0 0 0 0 1 1 1 1 
	0 0 0 0 0 0 0 0 0 0 0 0 1 1 1 
====================================

STEP 14
    Block Positions: p1: [12,0], p2: [12,0]
    Block Control: None
    Move: Move.Right

	0 0 0 0 0 0 1 1 1 1 1 1 1 0 0 
	1 1 1 1 0 0 1 1 1 0 0 1 1 0 0 
	1 1 1 1 1 1 1 1 1 0 0 1 1 1 1 
	1 1 1 1 0 0 0 0 0 0 0 1 1 1 1 
	1 1 1 1 0 0 0 0 0 0 0 1 1 1 1 
	0 0 0 0 0 0 0 0 0 0 0 0 1 1 1 
====================================

STEP 15
    Block Positions: p1: [12,1], p2: [12,2]
    Block Control: None
    Move: Move.Down

	0 0 0 0 0 0 1 1 1 1 1 1 1 0 0 
	1 1 1 1 0 0 1 1 1 0 0 1 1 0 0 
	1 1 1 1 1 1 1 1 1 0 0 1 1 1 1 
	1 1 1 1 0 0 0 0 0 0 0 1 1 1 1 
	1 1 1 1 0 0 0 0 0 0 0 1 1 1 1 
	0 0 0 0 0 0 0 0 0 0 0 0 1 1 1 
====================================

STEP 16
    Block Positions: p1: [12,3], p2: [12,3]
    Block Control: None
    Move: Move.Down

	0 0 0 0 0 0 1 1 1 1 1 1 1 0 0 
	1 1 1 1 0 0 1 1 1 0 0 1 1 0 0 
	1 1 1 1 1 1 1 1 1 0 0 1 1 1 1 
	1 1 1 1 0 0 0 0 0 0 0 1 1 1 1 
	1 1 1 1 0 0 0 0 0 0 0 1 1 1 1 
	0 0 0 0 0 0 0 0 0 0 0 0 1 1 1 
====================================

STEP 17
    Block Positions: p1: [12,4], p2: [12,5]
    Block Control: None
    Move: Move.Down

	0 0 0 0 0 0 1 1 1 1 1 1 1 0 0 
	1 1 1 1 0 0 1 1 1 0 0 1 1 0 0 
	1 1 1 1 1 1 1 1 1 0 0 1 1 1 1 
	1 1 1 1 0 0 0 0 0 0 0 1 1 1 1 
	1 1 1 1 0 0 0 0 0 0 0 1 1 1 1 
	0 0 0 0 0 0 0 0 0 0 0 0 1 1 1 
====================================

STEP 18
    Block Positions: p1: [13,4], p2: [13,5]
    Block Control: None
    Move: Move.Right

	0 0 0 0 0 0 1 1 1 1 1 1 1 0 0 
	1 1 1 1 0 0 1 1 1 0 0 1 1 0 0 
	1 1 1 1 1 1 1 1 1 0 0 1 1 1 1 
	1 1 1 1 0 0 0 0 0 0 0 1 1 1 1 
	1 1 1 1 0 0 0 0 0 0 0 1 1 1 1 
	0 0 0 0 0 0 0 0 0 0 0 0 1 1 1 
====================================

STEP 19
    Block Positions: p1: [13,3], p2: [13,3]
    Block Control: None
    Move: Move.Up

	0 0 0 0 0 0 1 1 1 1 1 1 1 0 0 
	1 1 1 1 0 0 1 1 1 0 0 1 1 0 0 
	1 1 1 1 1 1 1 1 1 0 0 1 1 1 1 
	1 1 1 1 0 0 0 0 0 0 0 1 1 1 1 
	1 1 1 1 0 0 0 0 0 0 0 1 1 1 1 
	0 0 0 0 0 0 0 0 0 0 0 0 1 1 1 
====================================
