Algorithm: GA
Time Consuming: 0.10999512672424316 Secs
Memory Consuming: 14.984375 MB

STEP 0
    Block Positions: p1: [1,4], p2: [1,4]
    Block Control: None
    Move: None

	0 0 0 0 0 0 0 0 1 1 1 0 0 0 
	0 0 0 0 0 0 0 0 1 1 1 0 0 0 
	0 0 0 0 0 0 0 0 1 1 1 0 0 0 
	1 1 1 1 1 1 0 0 1 1 1 1 1 1 
	1 1 1 1 5 1 0 0 1 1 1 1 1 1 
	1 1 1 1 1 1 0 0 1 1 1 1 1 1 
	0 0 0 0 0 0 0 0 1 1 1 0 0 0 
	0 0 0 0 0 0 0 0 1 1 1 0 0 0 
	0 0 0 0 0 0 0 0 1 1 1 0 0 0 
====================================

STEP 1
    Block Positions: p1: [2,4], p2: [3,4]
    Block Control: None
    Move: Move.Right

	0 0 0 0 0 0 0 0 1 1 1 0 0 0 
	0 0 0 0 0 0 0 0 1 1 1 0 0 0 
	0 0 0 0 0 0 0 0 1 1 1 0 0 0 
	1 1 1 1 1 1 0 0 1 1 1 1 1 1 
	1 1 1 1 5 1 0 0 1 1 1 1 1 1 
	1 1 1 1 1 1 0 0 1 1 1 1 1 1 
	0 0 0 0 0 0 0 0 1 1 1 0 0 0 
	0 0 0 0 0 0 0 0 1 1 1 0 0 0 
	0 0 0 0 0 0 0 0 1 1 1 0 0 0 
====================================

STEP 2
    Block Positions: p1: [9,1], p2: [9,7]
    Block Control: p1
    Move: Move.Right

	0 0 0 0 0 0 0 0 1 1 1 0 0 0 
	0 0 0 0 0 0 0 0 1 1 1 0 0 0 
	0 0 0 0 0 0 0 0 1 1 1 0 0 0 
	1 1 1 1 1 1 0 0 1 1 1 1 1 1 
	1 1 1 1 5 1 0 0 1 1 1 1 1 1 
	1 1 1 1 1 1 0 0 1 1 1 1 1 1 
	0 0 0 0 0 0 0 0 1 1 1 0 0 0 
	0 0 0 0 0 0 0 0 1 1 1 0 0 0 
	0 0 0 0 0 0 0 0 1 1 1 0 0 0 
====================================

STEP 3
    Block Positions: p1: [9,2], p2: [9,7]
    Block Control: p1
    Move: Move.Down

	0 0 0 0 0 0 0 0 1 1 1 0 0 0 
	0 0 0 0 0 0 0 0 1 1 1 0 0 0 
	0 0 0 0 0 0 0 0 1 1 1 0 0 0 
	1 1 1 1 1 1 0 0 1 1 1 1 1 1 
	1 1 1 1 5 1 0 0 1 1 1 1 1 1 
	1 1 1 1 1 1 0 0 1 1 1 1 1 1 
	0 0 0 0 0 0 0 0 1 1 1 0 0 0 
	0 0 0 0 0 0 0 0 1 1 1 0 0 0 
	0 0 0 0 0 0 0 0 1 1 1 0 0 0 
====================================

STEP 4
    Block Positions: p1: [9,3], p2: [9,7]
    Block Control: p1
    Move: Move.Down

	0 0 0 0 0 0 0 0 1 1 1 0 0 0 
	0 0 0 0 0 0 0 0 1 1 1 0 0 0 
	0 0 0 0 0 0 0 0 1 1 1 0 0 0 
	1 1 1 1 1 1 0 0 1 1 1 1 1 1 
	1 1 1 1 5 1 0 0 1 1 1 1 1 1 
	1 1 1 1 1 1 0 0 1 1 1 1 1 1 
	0 0 0 0 0 0 0 0 1 1 1 0 0 0 
	0 0 0 0 0 0 0 0 1 1 1 0 0 0 
	0 0 0 0 0 0 0 0 1 1 1 0 0 0 
====================================

STEP 5
    Block Positions: p1: [10,3], p2: [9,7]
    Block Control: p2
    Move: Move.Right

	0 0 0 0 0 0 0 0 1 1 1 0 0 0 
	0 0 0 0 0 0 0 0 1 1 1 0 0 0 
	0 0 0 0 0 0 0 0 1 1 1 0 0 0 
	1 1 1 1 1 1 0 0 1 1 1 1 1 1 
	1 1 1 1 5 1 0 0 1 1 1 1 1 1 
	1 1 1 1 1 1 0 0 1 1 1 1 1 1 
	0 0 0 0 0 0 0 0 1 1 1 0 0 0 
	0 0 0 0 0 0 0 0 1 1 1 0 0 0 
	0 0 0 0 0 0 0 0 1 1 1 0 0 0 
====================================

STEP 6
    Block Positions: p1: [10,3], p2: [9,7]
    Block Control: p2
    Move: Move.Space

	0 0 0 0 0 0 0 0 1 1 1 0 0 0 
	0 0 0 0 0 0 0 0 1 1 1 0 0 0 
	0 0 0 0 0 0 0 0 1 1 1 0 0 0 
	1 1 1 1 1 1 0 0 1 1 1 1 1 1 
	1 1 1 1 5 1 0 0 1 1 1 1 1 1 
	1 1 1 1 1 1 0 0 1 1 1 1 1 1 
	0 0 0 0 0 0 0 0 1 1 1 0 0 0 
	0 0 0 0 0 0 0 0 1 1 1 0 0 0 
	0 0 0 0 0 0 0 0 1 1 1 0 0 0 
====================================

STEP 7
    Block Positions: p1: [10,3], p2: [8,7]
    Block Control: p2
    Move: Move.Left

	0 0 0 0 0 0 0 0 1 1 1 0 0 0 
	0 0 0 0 0 0 0 0 1 1 1 0 0 0 
	0 0 0 0 0 0 0 0 1 1 1 0 0 0 
	1 1 1 1 1 1 0 0 1 1 1 1 1 1 
	1 1 1 1 5 1 0 0 1 1 1 1 1 1 
	1 1 1 1 1 1 0 0 1 1 1 1 1 1 
	0 0 0 0 0 0 0 0 1 1 1 0 0 0 
	0 0 0 0 0 0 0 0 1 1 1 0 0 0 
	0 0 0 0 0 0 0 0 1 1 1 0 0 0 
====================================

STEP 8
    Block Positions: p1: [10,3], p2: [8,6]
    Block Control: p2
    Move: Move.Up

	0 0 0 0 0 0 0 0 1 1 1 0 0 0 
	0 0 0 0 0 0 0 0 1 1 1 0 0 0 
	0 0 0 0 0 0 0 0 1 1 1 0 0 0 
	1 1 1 1 1 1 0 0 1 1 1 1 1 1 
	1 1 1 1 5 1 0 0 1 1 1 1 1 1 
	1 1 1 1 1 1 0 0 1 1 1 1 1 1 
	0 0 0 0 0 0 0 0 1 1 1 0 0 0 
	0 0 0 0 0 0 0 0 1 1 1 0 0 0 
	0 0 0 0 0 0 0 0 1 1 1 0 0 0 
====================================

STEP 9
    Block Positions: p1: [10,3], p2: [9,6]
    Block Control: p2
    Move: Move.Right

	0 0 0 0 0 0 0 0 1 1 1 0 0 0 
	0 0 0 0 0 0 0 0 1 1 1 0 0 0 
	0 0 0 0 0 0 0 0 1 1 1 0 0 0 
	1 1 1 1 1 1 0 0 1 1 1 1 1 1 
	1 1 1 1 5 1 0 0 1 1 1 1 1 1 
	1 1 1 1 1 1 0 0 1 1 1 1 1 1 
	0 0 0 0 0 0 0 0 1 1 1 0 0 0 
	0 0 0 0 0 0 0 0 1 1 1 0 0 0 
	0 0 0 0 0 0 0 0 1 1 1 0 0 0 
====================================

STEP 10
    Block Positions: p1: [10,3], p2: [9,7]
    Block Control: p2
    Move: Move.Down

	0 0 0 0 0 0 0 0 1 1 1 0 0 0 
	0 0 0 0 0 0 0 0 1 1 1 0 0 0 
	0 0 0 0 0 0 0 0 1 1 1 0 0 0 
	1 1 1 1 1 1 0 0 1 1 1 1 1 1 
	1 1 1 1 5 1 0 0 1 1 1 1 1 1 
	1 1 1 1 1 1 0 0 1 1 1 1 1 1 
	0 0 0 0 0 0 0 0 1 1 1 0 0 0 
	0 0 0 0 0 0 0 0 1 1 1 0 0 0 
	0 0 0 0 0 0 0 0 1 1 1 0 0 0 
====================================

STEP 11
    Block Positions: p1: [10,3], p2: [10,7]
    Block Control: p2
    Move: Move.Right

	0 0 0 0 0 0 0 0 1 1 1 0 0 0 
	0 0 0 0 0 0 0 0 1 1 1 0 0 0 
	0 0 0 0 0 0 0 0 1 1 1 0 0 0 
	1 1 1 1 1 1 0 0 1 1 1 1 1 1 
	1 1 1 1 5 1 0 0 1 1 1 1 1 1 
	1 1 1 1 1 1 0 0 1 1 1 1 1 1 
	0 0 0 0 0 0 0 0 1 1 1 0 0 0 
	0 0 0 0 0 0 0 0 1 1 1 0 0 0 
	0 0 0 0 0 0 0 0 1 1 1 0 0 0 
====================================

STEP 12
    Block Positions: p1: [10,3], p2: [10,6]
    Block Control: p2
    Move: Move.Up

	0 0 0 0 0 0 0 0 1 1 1 0 0 0 
	0 0 0 0 0 0 0 0 1 1 1 0 0 0 
	0 0 0 0 0 0 0 0 1 1 1 0 0 0 
	1 1 1 1 1 1 0 0 1 1 1 1 1 1 
	1 1 1 1 5 1 0 0 1 1 1 1 1 1 
	1 1 1 1 1 1 0 0 1 1 1 1 1 1 
	0 0 0 0 0 0 0 0 1 1 1 0 0 0 
	0 0 0 0 0 0 0 0 1 1 1 0 0 0 
	0 0 0 0 0 0 0 0 1 1 1 0 0 0 
====================================

STEP 13
    Block Positions: p1: [10,3], p2: [10,5]
    Block Control: p2
    Move: Move.Up

	0 0 0 0 0 0 0 0 1 1 1 0 0 0 
	0 0 0 0 0 0 0 0 1 1 1 0 0 0 
	0 0 0 0 0 0 0 0 1 1 1 0 0 0 
	1 1 1 1 1 1 0 0 1 1 1 1 1 1 
	1 1 1 1 5 1 0 0 1 1 1 1 1 1 
	1 1 1 1 1 1 0 0 1 1 1 1 1 1 
	0 0 0 0 0 0 0 0 1 1 1 0 0 0 
	0 0 0 0 0 0 0 0 1 1 1 0 0 0 
	0 0 0 0 0 0 0 0 1 1 1 0 0 0 
====================================

STEP 14
    Block Positions: p1: [10,3], p2: [11,5]
    Block Control: p2
    Move: Move.Right

	0 0 0 0 0 0 0 0 1 1 1 0 0 0 
	0 0 0 0 0 0 0 0 1 1 1 0 0 0 
	0 0 0 0 0 0 0 0 1 1 1 0 0 0 
	1 1 1 1 1 1 0 0 1 1 1 1 1 1 
	1 1 1 1 5 1 0 0 1 1 1 1 1 1 
	1 1 1 1 1 1 0 0 1 1 1 1 1 1 
	0 0 0 0 0 0 0 0 1 1 1 0 0 0 
	0 0 0 0 0 0 0 0 1 1 1 0 0 0 
	0 0 0 0 0 0 0 0 1 1 1 0 0 0 
====================================

STEP 15
    Block Positions: p1: [10,3], p2: [11,4]
    Block Control: p2
    Move: Move.Up

	0 0 0 0 0 0 0 0 1 1 1 0 0 0 
	0 0 0 0 0 0 0 0 1 1 1 0 0 0 
	0 0 0 0 0 0 0 0 1 1 1 0 0 0 
	1 1 1 1 1 1 0 0 1 1 1 1 1 1 
	1 1 1 1 5 1 0 0 1 1 1 1 1 1 
	1 1 1 1 1 1 0 0 1 1 1 1 1 1 
	0 0 0 0 0 0 0 0 1 1 1 0 0 0 
	0 0 0 0 0 0 0 0 1 1 1 0 0 0 
	0 0 0 0 0 0 0 0 1 1 1 0 0 0 
====================================

STEP 16
    Block Positions: p1: [10,3], p2: [11,3]
    Block Control: None
    Move: Move.Up

	0 0 0 0 0 0 0 0 1 1 1 0 0 0 
	0 0 0 0 0 0 0 0 1 1 1 0 0 0 
	0 0 0 0 0 0 0 0 1 1 1 0 0 0 
	1 1 1 1 1 1 0 0 1 1 1 1 1 1 
	1 1 1 1 5 1 0 0 1 1 1 1 1 1 
	1 1 1 1 1 1 0 0 1 1 1 1 1 1 
	0 0 0 0 0 0 0 0 1 1 1 0 0 0 
	0 0 0 0 0 0 0 0 1 1 1 0 0 0 
	0 0 0 0 0 0 0 0 1 1 1 0 0 0 
====================================

STEP 17
    Block Positions: p1: [10,4], p2: [11,4]
    Block Control: None
    Move: Move.Down

	0 0 0 0 0 0 0 0 1 1 1 0 0 0 
	0 0 0 0 0 0 0 0 1 1 1 0 0 0 
	0 0 0 0 0 0 0 0 1 1 1 0 0 0 
	1 1 1 1 1 1 0 0 1 1 1 1 1 1 
	1 1 1 1 5 1 0 0 1 1 1 1 1 1 
	1 1 1 1 1 1 0 0 1 1 1 1 1 1 
	0 0 0 0 0 0 0 0 1 1 1 0 0 0 
	0 0 0 0 0 0 0 0 1 1 1 0 0 0 
	0 0 0 0 0 0 0 0 1 1 1 0 0 0 
====================================

STEP 18
    Block Positions: p1: [12,4], p2: [12,4]
    Block Control: None
    Move: Move.Right

	0 0 0 0 0 0 0 0 1 1 1 0 0 0 
	0 0 0 0 0 0 0 0 1 1 1 0 0 0 
	0 0 0 0 0 0 0 0 1 1 1 0 0 0 
	1 1 1 1 1 1 0 0 1 1 1 1 1 1 
	1 1 1 1 5 1 0 0 1 1 1 1 1 1 
	1 1 1 1 1 1 0 0 1 1 1 1 1 1 
	0 0 0 0 0 0 0 0 1 1 1 0 0 0 
	0 0 0 0 0 0 0 0 1 1 1 0 0 0 
	0 0 0 0 0 0 0 0 1 1 1 0 0 0 
====================================
