Algorithm: GA
Time Consuming: 0.21599841117858887 Secs
Memory Consuming: 14.5546875 MB

STEP 0
    Block Positions: p1: [1,4], p2: [1,4]
    Block Control: None
    Move: None

	0 0 0 0 0 0 1 1 1 1 0 0 1 1 1 
	1 1 1 1 0 0 1 1 2 1 0 0 1 1 1 
	1 1 2 1 0 0 1 1 1 1 0 0 1 1 1 
	1 1 1 1 0 0 1 1 1 1 0 0 1 1 1 
	1 1 1 1 0 0 1 1 1 1 0 0 1 1 1 
====================================

STEP 1
    Block Positions: p1: [1,2], p2: [1,3]
    Block Control: None
    Move: Move.Up

	0 0 0 0 0 0 1 1 1 1 0 0 1 1 1 
	1 1 1 1 0 0 1 1 2 1 0 0 1 1 1 
	1 1 2 1 0 0 1 1 1 1 0 0 1 1 1 
	1 1 1 1 0 0 1 1 1 1 0 0 1 1 1 
	1 1 1 1 0 0 1 1 1 1 0 0 1 1 1 
====================================

STEP 2
    Block Positions: p1: [2,2], p2: [2,3]
    Block Control: None
    Move: Move.Right

	0 0 0 0 0 0 1 1 1 1 0 0 1 1 1 
	1 1 1 1 0 0 1 1 2 1 0 0 1 1 1 
	1 1 2 1 0 0 1 1 1 1 0 0 1 1 1 
	1 1 1 1 0 0 1 1 1 1 0 0 1 1 1 
	1 1 1 1 0 0 1 1 1 1 0 0 1 1 1 
====================================

STEP 3
    Block Positions: p1: [3,2], p2: [3,3]
    Block Control: None
    Move: Move.Right

	0 0 0 0 0 0 1 1 1 1 0 0 1 1 1 
	1 1 1 1 0 0 1 1 2 1 0 0 1 1 1 
	1 1 2 1 0 0 1 1 1 1 0 0 1 1 1 
	1 1 1 1 0 0 1 1 1 1 0 0 1 1 1 
	1 1 1 1 0 0 1 1 1 1 0 0 1 1 1 
====================================

STEP 4
    Block Positions: p1: [3,4], p2: [3,4]
    Block Control: None
    Move: Move.Down

	0 0 0 0 0 0 1 1 1 1 0 0 1 1 1 
	1 1 1 1 0 0 1 1 2 1 0 0 1 1 1 
	1 1 2 1 0 0 1 1 1 1 0 0 1 1 1 
	1 1 1 1 0 0 1 1 1 1 0 0 1 1 1 
	1 1 1 1 0 0 1 1 1 1 0 0 1 1 1 
====================================

STEP 5
    Block Positions: p1: [6,4], p2: [6,4]
    Block Control: None
    Move: Move.Right

	0 0 0 0 0 0 1 1 1 1 0 0 1 1 1 
	1 1 1 1 0 0 1 1 2 1 0 0 1 1 1 
	1 1 2 1 0 0 1 1 1 1 0 0 1 1 1 
	1 1 1 1 0 0 1 1 1 1 0 0 1 1 1 
	1 1 1 1 0 0 1 1 1 1 0 0 1 1 1 
====================================

STEP 6
    Block Positions: p1: [7,4], p2: [8,4]
    Block Control: None
    Move: Move.Right

	0 0 0 0 0 0 1 1 1 1 0 0 1 1 1 
	1 1 1 1 0 0 1 1 2 1 0 0 1 1 1 
	1 1 2 1 0 0 1 1 1 1 0 0 1 1 1 
	1 1 1 1 0 0 1 1 1 1 0 0 1 1 1 
	1 1 1 1 0 0 1 1 1 1 0 0 1 1 1 
====================================

STEP 7
    Block Positions: p1: [9,4], p2: [9,4]
    Block Control: None
    Move: Move.Right

	0 0 0 0 0 0 1 1 1 1 0 0 1 1 1 
	1 1 1 1 0 0 1 1 2 1 0 0 1 1 1 
	1 1 2 1 0 0 1 1 1 1 0 0 1 1 1 
	1 1 1 1 0 0 1 1 1 1 0 0 1 1 1 
	1 1 1 1 0 0 1 1 1 1 0 0 1 1 1 
====================================

STEP 8
    Block Positions: p1: [9,2], p2: [9,3]
    Block Control: None
    Move: Move.Up

	0 0 0 0 0 0 1 1 1 1 0 0 1 1 1 
	1 1 1 1 0 0 1 1 2 1 0 0 1 1 1 
	1 1 2 1 0 0 1 1 1 1 0 0 1 1 1 
	1 1 1 1 0 0 1 1 1 1 0 0 1 1 1 
	1 1 1 1 0 0 1 1 1 1 0 0 1 1 1 
====================================

STEP 9
    Block Positions: p1: [8,2], p2: [8,3]
    Block Control: None
    Move: Move.Left

	0 0 0 0 0 0 1 1 1 1 0 0 1 1 1 
	1 1 1 1 0 0 1 1 2 1 0 0 1 1 1 
	1 1 2 1 0 0 1 1 1 1 0 0 1 1 1 
	1 1 1 1 0 0 1 1 1 1 0 0 1 1 1 
	1 1 1 1 0 0 1 1 1 1 0 0 1 1 1 
====================================

STEP 10
    Block Positions: p1: [7,2], p2: [7,3]
    Block Control: None
    Move: Move.Left

	0 0 0 0 0 0 1 1 1 1 0 0 1 1 1 
	1 1 1 1 0 0 1 1 2 1 0 0 1 1 1 
	1 1 2 1 0 0 1 1 1 1 0 0 1 1 1 
	1 1 1 1 0 0 1 1 1 1 0 0 1 1 1 
	1 1 1 1 0 0 1 1 1 1 0 0 1 1 1 
====================================

STEP 11
    Block Positions: p1: [6,2], p2: [6,3]
    Block Control: None
    Move: Move.Left

	0 0 0 0 0 0 1 1 1 1 0 0 1 1 1 
	1 1 1 1 0 0 1 1 2 1 0 0 1 1 1 
	1 1 2 1 0 0 1 1 1 1 0 0 1 1 1 
	1 1 1 1 0 0 1 1 1 1 0 0 1 1 1 
	1 1 1 1 0 0 1 1 1 1 0 0 1 1 1 
====================================

STEP 12
    Block Positions: p1: [6,1], p2: [6,1]
    Block Control: None
    Move: Move.Up

	0 0 0 0 0 0 1 1 1 1 0 0 1 1 1 
	1 1 1 1 0 0 1 1 2 1 0 0 1 1 1 
	1 1 2 1 0 0 1 1 1 1 0 0 1 1 1 
	1 1 1 1 0 0 1 1 1 1 0 0 1 1 1 
	1 1 1 1 0 0 1 1 1 1 0 0 1 1 1 
====================================

STEP 13
    Block Positions: p1: [7,1], p2: [8,1]
    Block Control: None
    Move: Move.Right

	0 0 0 0 0 0 1 1 1 1 0 0 1 1 1 
	1 1 1 1 0 0 1 1 2 1 0 0 1 1 1 
	1 1 2 1 0 0 1 1 1 1 0 0 1 1 1 
	1 1 1 1 0 0 1 1 1 1 0 0 1 1 1 
	1 1 1 1 0 0 1 1 1 1 0 0 1 1 1 
====================================

STEP 14
    Block Positions: p1: [9,1], p2: [9,1]
    Block Control: None
    Move: Move.Right

	0 0 0 0 0 0 1 1 1 1 0 0 1 1 1 
	1 1 1 1 0 0 1 1 2 1 0 0 1 1 1 
	1 1 2 1 0 0 1 1 1 1 0 0 1 1 1 
	1 1 1 1 0 0 1 1 1 1 0 0 1 1 1 
	1 1 1 1 0 0 1 1 1 1 0 0 1 1 1 
====================================

STEP 15
    Block Positions: p1: [9,2], p2: [9,3]
    Block Control: None
    Move: Move.Down

	0 0 0 0 0 0 1 1 1 1 0 0 1 1 1 
	1 1 1 1 0 0 1 1 2 1 0 0 1 1 1 
	1 1 2 1 0 0 1 1 1 1 0 0 1 1 1 
	1 1 1 1 0 0 1 1 1 1 0 0 1 1 1 
	1 1 1 1 0 0 1 1 1 1 0 0 1 1 1 
====================================

STEP 16
    Block Positions: p1: [8,2], p2: [8,3]
    Block Control: None
    Move: Move.Left

	0 0 0 0 0 0 1 1 1 1 0 0 1 1 1 
	1 1 1 1 0 0 1 1 2 1 0 0 1 1 1 
	1 1 2 1 0 0 1 1 1 1 0 0 1 1 1 
	1 1 1 1 0 0 1 1 1 1 0 0 1 1 1 
	1 1 1 1 0 0 1 1 1 1 0 0 1 1 1 
====================================

STEP 17
    Block Positions: p1: [8,1], p2: [8,1]
    Block Control: None
    Move: Move.Up

	0 0 0 0 0 0 1 1 1 1 0 0 1 1 1 
	1 1 1 1 0 0 1 1 2 1 0 0 1 1 1 
	1 1 2 1 0 0 1 1 1 1 0 0 1 1 1 
	1 1 1 1 0 0 1 1 1 1 0 0 1 1 1 
	1 1 1 1 0 0 1 1 1 1 0 0 1 1 1 
====================================

STEP 18
    Block Positions: p1: [8,2], p2: [8,3]
    Block Control: None
    Move: Move.Down

	0 0 0 0 0 0 1 1 1 1 0 0 1 1 1 
	1 1 1 1 0 0 1 1 2 1 0 0 1 1 1 
	1 1 2 1 0 0 1 1 1 1 0 0 1 1 1 
	1 1 1 1 0 0 1 1 1 1 0 0 1 1 1 
	1 1 1 1 0 0 1 1 1 1 0 0 1 1 1 
====================================

STEP 19
    Block Positions: p1: [7,2], p2: [7,3]
    Block Control: None
    Move: Move.Left

	0 0 0 0 0 0 1 1 1 1 0 0 1 1 1 
	1 1 1 1 0 0 1 1 2 1 0 0 1 1 1 
	1 1 2 1 0 0 1 1 1 1 0 0 1 1 1 
	1 1 1 1 0 0 1 1 1 1 0 0 1 1 1 
	1 1 1 1 0 0 1 1 1 1 0 0 1 1 1 
====================================

STEP 20
    Block Positions: p1: [6,2], p2: [6,3]
    Block Control: None
    Move: Move.Left

	0 0 0 0 0 0 1 1 1 1 0 0 1 1 1 
	1 1 1 1 0 0 1 1 2 1 0 0 1 1 1 
	1 1 2 1 0 0 1 1 1 1 0 0 1 1 1 
	1 1 1 1 0 0 1 1 1 1 0 0 1 1 1 
	1 1 1 1 0 0 1 1 1 1 0 0 1 1 1 
====================================

STEP 21
    Block Positions: p1: [6,1], p2: [6,1]
    Block Control: None
    Move: Move.Up

	0 0 0 0 0 0 1 1 1 1 0 0 1 1 1 
	1 1 1 1 0 0 1 1 2 1 0 0 1 1 1 
	1 1 2 1 0 0 1 1 1 1 0 0 1 1 1 
	1 1 1 1 0 0 1 1 1 1 0 0 1 1 1 
	1 1 1 1 0 0 1 1 1 1 0 0 1 1 1 
====================================

STEP 22
    Block Positions: p1: [7,1], p2: [8,1]
    Block Control: None
    Move: Move.Right

	0 0 0 0 0 0 1 1 1 1 0 0 1 1 1 
	1 1 1 1 0 0 1 1 2 1 0 0 1 1 1 
	1 1 2 1 0 0 1 1 1 1 0 0 1 1 1 
	1 1 1 1 0 0 1 1 1 1 0 0 1 1 1 
	1 1 1 1 0 0 1 1 1 1 0 0 1 1 1 
====================================

STEP 23
    Block Positions: p1: [9,1], p2: [9,1]
    Block Control: None
    Move: Move.Right

	0 0 0 0 0 0 1 1 1 1 0 0 1 1 1 
	1 1 1 1 0 0 1 1 2 1 0 0 1 1 1 
	1 1 2 1 0 0 1 1 1 1 0 0 1 1 1 
	1 1 1 1 0 0 1 1 1 1 0 0 1 1 1 
	1 1 1 1 0 0 1 1 1 1 0 0 1 1 1 
====================================

STEP 24
    Block Positions: p1: [9,2], p2: [9,3]
    Block Control: None
    Move: Move.Down

	0 0 0 0 0 0 1 1 1 1 0 0 1 1 1 
	1 1 1 1 0 0 1 1 2 1 0 0 1 1 1 
	1 1 2 1 0 0 1 1 1 1 0 0 1 1 1 
	1 1 1 1 0 0 1 1 1 1 0 0 1 1 1 
	1 1 1 1 0 0 1 1 1 1 0 0 1 1 1 
====================================

STEP 25
    Block Positions: p1: [8,2], p2: [8,3]
    Block Control: None
    Move: Move.Left

	0 0 0 0 0 0 1 1 1 1 0 0 1 1 1 
	1 1 1 1 0 0 1 1 2 1 0 0 1 1 1 
	1 1 2 1 0 0 1 1 1 1 0 0 1 1 1 
	1 1 1 1 0 0 1 1 1 1 0 0 1 1 1 
	1 1 1 1 0 0 1 1 1 1 0 0 1 1 1 
====================================

STEP 26
    Block Positions: p1: [8,4], p2: [8,4]
    Block Control: None
    Move: Move.Down

	0 0 0 0 0 0 1 1 1 1 0 0 1 1 1 
	1 1 1 1 0 0 1 1 2 1 0 0 1 1 1 
	1 1 2 1 0 0 1 1 1 1 0 0 1 1 1 
	1 1 1 1 0 0 1 1 1 1 0 0 1 1 1 
	1 1 1 1 0 0 1 1 1 1 0 0 1 1 1 
====================================

STEP 27
    Block Positions: p1: [12,4], p2: [13,4]
    Block Control: None
    Move: Move.Right

	0 0 0 0 0 0 1 1 1 1 0 0 1 1 1 
	1 1 1 1 0 0 1 1 2 1 0 0 1 1 1 
	1 1 2 1 0 0 1 1 1 1 0 0 1 1 1 
	1 1 1 1 0 0 1 1 1 1 0 0 1 1 1 
	1 1 1 1 0 0 1 1 1 1 0 0 1 1 1 
====================================

STEP 28
    Block Positions: p1: [14,4], p2: [14,4]
    Block Control: None
    Move: Move.Right

	0 0 0 0 0 0 1 1 1 1 0 0 1 1 1 
	1 1 1 1 0 0 1 1 2 1 0 0 1 1 1 
	1 1 2 1 0 0 1 1 1 1 0 0 1 1 1 
	1 1 1 1 0 0 1 1 1 1 0 0 1 1 1 
	1 1 1 1 0 0 1 1 1 1 0 0 1 1 1 
====================================

STEP 29
    Block Positions: p1: [14,2], p2: [14,3]
    Block Control: None
    Move: Move.Up

	0 0 0 0 0 0 1 1 1 1 0 0 1 1 1 
	1 1 1 1 0 0 1 1 2 1 0 0 1 1 1 
	1 1 2 1 0 0 1 1 1 1 0 0 1 1 1 
	1 1 1 1 0 0 1 1 1 1 0 0 1 1 1 
	1 1 1 1 0 0 1 1 1 1 0 0 1 1 1 
====================================

STEP 30
    Block Positions: p1: [13,2], p2: [13,3]
    Block Control: None
    Move: Move.Left

	0 0 0 0 0 0 1 1 1 1 0 0 1 1 1 
	1 1 1 1 0 0 1 1 2 1 0 0 1 1 1 
	1 1 2 1 0 0 1 1 1 1 0 0 1 1 1 
	1 1 1 1 0 0 1 1 1 1 0 0 1 1 1 
	1 1 1 1 0 0 1 1 1 1 0 0 1 1 1 
====================================

STEP 31
    Block Positions: p1: [13,1], p2: [13,1]
    Block Control: None
    Move: Move.Up

	0 0 0 0 0 0 1 1 1 1 0 0 1 1 1 
	1 1 1 1 0 0 1 1 2 1 0 0 1 1 1 
	1 1 2 1 0 0 1 1 1 1 0 0 1 1 1 
	1 1 1 1 0 0 1 1 1 1 0 0 1 1 1 
	1 1 1 1 0 0 1 1 1 1 0 0 1 1 1 
====================================
