Algorithm: GA
Time Consuming: 1.0928564071655273 Secs
Memory Consuming: 14.66796875 MB

STEP 0
    Block Positions: p1: [1,3], p2: [1,3]
    Block Control: None
    Move: None

	0 0 0 0 0 0 1 1 1 1 1 1 1 0 0 
	1 1 1 1 0 0 1 1 1 0 0 1 1 0 0 
	1 1 1 1 1 1 1 1 1 0 0 1 1 1 1 
	1 1 1 1 0 0 0 0 0 0 0 1 1 1 1 
	1 1 1 1 0 0 0 0 0 0 0 1 1 1 1 
	0 0 0 0 0 0 0 0 0 0 0 0 1 1 1 
====================================

STEP 1
    Block Positions: p1: [2,3], p2: [3,3]
    Block Control: None
    Move: Move.Right

	0 0 0 0 0 0 1 1 1 1 1 1 1 0 0 
	1 1 1 1 0 0 1 1 1 0 0 1 1 0 0 
	1 1 1 1 1 1 1 1 1 0 0 1 1 1 1 
	1 1 1 1 0 0 0 0 0 0 0 1 1 1 1 
	1 1 1 1 0 0 0 0 0 0 0 1 1 1 1 
	0 0 0 0 0 0 0 0 0 0 0 0 1 1 1 
====================================

STEP 2
    Block Positions: p1: [2,2], p2: [3,2]
    Block Control: None
    Move: Move.Up

	0 0 0 0 0 0 1 1 1 1 1 1 1 0 0 
	1 1 1 1 0 0 1 1 1 0 0 1 1 0 0 
	1 1 1 1 1 1 1 1 1 0 0 1 1 1 1 
	1 1 1 1 0 0 0 0 0 0 0 1 1 1 1 
	1 1 1 1 0 0 0 0 0 0 0 1 1 1 1 
	0 0 0 0 0 0 0 0 0 0 0 0 1 1 1 
====================================

STEP 3
    Block Positions: p1: [4,2], p2: [4,2]
    Block Control: None
    Move: Move.Right

	0 0 0 0 0 0 1 1 1 1 1 1 1 0 0 
	1 1 1 1 0 0 1 1 1 0 0 1 1 0 0 
	1 1 1 1 1 1 1 1 1 0 0 1 1 1 1 
	1 1 1 1 0 0 0 0 0 0 0 1 1 1 1 
	1 1 1 1 0 0 0 0 0 0 0 1 1 1 1 
	0 0 0 0 0 0 0 0 0 0 0 0 1 1 1 
====================================

STEP 4
    Block Positions: p1: [2,2], p2: [3,2]
    Block Control: None
    Move: Move.Left

	0 0 0 0 0 0 1 1 1 1 1 1 1 0 0 
	1 1 1 1 0 0 1 1 1 0 0 1 1 0 0 
	1 1 1 1 1 1 1 1 1 0 0 1 1 1 1 
	1 1 1 1 0 0 0 0 0 0 0 1 1 1 1 
	1 1 1 1 0 0 0 0 0 0 0 1 1 1 1 
	0 0 0 0 0 0 0 0 0 0 0 0 1 1 1 
====================================

STEP 5
    Block Positions: p1: [4,2], p2: [4,2]
    Block Control: None
    Move: Move.Right

	0 0 0 0 0 0 1 1 1 1 1 1 1 0 0 
	1 1 1 1 0 0 1 1 1 0 0 1 1 0 0 
	1 1 1 1 1 1 1 1 1 0 0 1 1 1 1 
	1 1 1 1 0 0 0 0 0 0 0 1 1 1 1 
	1 1 1 1 0 0 0 0 0 0 0 1 1 1 1 
	0 0 0 0 0 0 0 0 0 0 0 0 1 1 1 
====================================

STEP 6
    Block Positions: p1: [5,2], p2: [6,2]
    Block Control: None
    Move: Move.Right

	0 0 0 0 0 0 1 1 1 1 1 1 1 0 0 
	1 1 1 1 0 0 1 1 1 0 0 1 1 0 0 
	1 1 1 1 1 1 1 1 1 0 0 1 1 1 1 
	1 1 1 1 0 0 0 0 0 0 0 1 1 1 1 
	1 1 1 1 0 0 0 0 0 0 0 1 1 1 1 
	0 0 0 0 0 0 0 0 0 0 0 0 1 1 1 
====================================

STEP 7
    Block Positions: p1: [7,2], p2: [7,2]
    Block Control: None
    Move: Move.Right

	0 0 0 0 0 0 1 1 1 1 1 1 1 0 0 
	1 1 1 1 0 0 1 1 1 0 0 1 1 0 0 
	1 1 1 1 1 1 1 1 1 0 0 1 1 1 1 
	1 1 1 1 0 0 0 0 0 0 0 1 1 1 1 
	1 1 1 1 0 0 0 0 0 0 0 1 1 1 1 
	0 0 0 0 0 0 0 0 0 0 0 0 1 1 1 
====================================

STEP 8
    Block Positions: p1: [7,0], p2: [7,1]
    Block Control: None
    Move: Move.Up

	0 0 0 0 0 0 1 1 1 1 1 1 1 0 0 
	1 1 1 1 0 0 1 1 1 0 0 1 1 0 0 
	1 1 1 1 1 1 1 1 1 0 0 1 1 1 1 
	1 1 1 1 0 0 0 0 0 0 0 1 1 1 1 
	1 1 1 1 0 0 0 0 0 0 0 1 1 1 1 
	0 0 0 0 0 0 0 0 0 0 0 0 1 1 1 
====================================

STEP 9
    Block Positions: p1: [8,0], p2: [8,1]
    Block Control: None
    Move: Move.Right

	0 0 0 0 0 0 1 1 1 1 1 1 1 0 0 
	1 1 1 1 0 0 1 1 1 0 0 1 1 0 0 
	1 1 1 1 1 1 1 1 1 0 0 1 1 1 1 
	1 1 1 1 0 0 0 0 0 0 0 1 1 1 1 
	1 1 1 1 0 0 0 0 0 0 0 1 1 1 1 
	0 0 0 0 0 0 0 0 0 0 0 0 1 1 1 
====================================

STEP 10
    Block Positions: p1: [8,2], p2: [8,2]
    Block Control: None
    Move: Move.Down

	0 0 0 0 0 0 1 1 1 1 1 1 1 0 0 
	1 1 1 1 0 0 1 1 1 0 0 1 1 0 0 
	1 1 1 1 1 1 1 1 1 0 0 1 1 1 1 
	1 1 1 1 0 0 0 0 0 0 0 1 1 1 1 
	1 1 1 1 0 0 0 0 0 0 0 1 1 1 1 
	0 0 0 0 0 0 0 0 0 0 0 0 1 1 1 
====================================

STEP 11
    Block Positions: p1: [6,2], p2: [7,2]
    Block Control: None
    Move: Move.Left

	0 0 0 0 0 0 1 1 1 1 1 1 1 0 0 
	1 1 1 1 0 0 1 1 1 0 0 1 1 0 0 
	1 1 1 1 1 1 1 1 1 0 0 1 1 1 1 
	1 1 1 1 0 0 0 0 0 0 0 1 1 1 1 
	1 1 1 1 0 0 0 0 0 0 0 1 1 1 1 
	0 0 0 0 0 0 0 0 0 0 0 0 1 1 1 
====================================

STEP 12
    Block Positions: p1: [6,1], p2: [7,1]
    Block Control: None
    Move: Move.Up

	0 0 0 0 0 0 1 1 1 1 1 1 1 0 0 
	1 1 1 1 0 0 1 1 1 0 0 1 1 0 0 
	1 1 1 1 1 1 1 1 1 0 0 1 1 1 1 
	1 1 1 1 0 0 0 0 0 0 0 1 1 1 1 
	1 1 1 1 0 0 0 0 0 0 0 1 1 1 1 
	0 0 0 0 0 0 0 0 0 0 0 0 1 1 1 
====================================

STEP 13
    Block Positions: p1: [6,0], p2: [7,0]
    Block Control: None
    Move: Move.Up

	0 0 0 0 0 0 1 1 1 1 1 1 1 0 0 
	1 1 1 1 0 0 1 1 1 0 0 1 1 0 0 
	1 1 1 1 1 1 1 1 1 0 0 1 1 1 1 
	1 1 1 1 0 0 0 0 0 0 0 1 1 1 1 
	1 1 1 1 0 0 0 0 0 0 0 1 1 1 1 
	0 0 0 0 0 0 0 0 0 0 0 0 1 1 1 
====================================

STEP 14
    Block Positions: p1: [6,1], p2: [7,1]
    Block Control: None
    Move: Move.Down

	0 0 0 0 0 0 1 1 1 1 1 1 1 0 0 
	1 1 1 1 0 0 1 1 1 0 0 1 1 0 0 
	1 1 1 1 1 1 1 1 1 0 0 1 1 1 1 
	1 1 1 1 0 0 0 0 0 0 0 1 1 1 1 
	1 1 1 1 0 0 0 0 0 0 0 1 1 1 1 
	0 0 0 0 0 0 0 0 0 0 0 0 1 1 1 
====================================

STEP 15
    Block Positions: p1: [6,0], p2: [7,0]
    Block Control: None
    Move: Move.Up

	0 0 0 0 0 0 1 1 1 1 1 1 1 0 0 
	1 1 1 1 0 0 1 1 1 0 0 1 1 0 0 
	1 1 1 1 1 1 1 1 1 0 0 1 1 1 1 
	1 1 1 1 0 0 0 0 0 0 0 1 1 1 1 
	1 1 1 1 0 0 0 0 0 0 0 1 1 1 1 
	0 0 0 0 0 0 0 0 0 0 0 0 1 1 1 
====================================

STEP 16
    Block Positions: p1: [8,0], p2: [8,0]
    Block Control: None
    Move: Move.Right

	0 0 0 0 0 0 1 1 1 1 1 1 1 0 0 
	1 1 1 1 0 0 1 1 1 0 0 1 1 0 0 
	1 1 1 1 1 1 1 1 1 0 0 1 1 1 1 
	1 1 1 1 0 0 0 0 0 0 0 1 1 1 1 
	1 1 1 1 0 0 0 0 0 0 0 1 1 1 1 
	0 0 0 0 0 0 0 0 0 0 0 0 1 1 1 
====================================

STEP 17
    Block Positions: p1: [9,0], p2: [10,0]
    Block Control: None
    Move: Move.Right

	0 0 0 0 0 0 1 1 1 1 1 1 1 0 0 
	1 1 1 1 0 0 1 1 1 0 0 1 1 0 0 
	1 1 1 1 1 1 1 1 1 0 0 1 1 1 1 
	1 1 1 1 0 0 0 0 0 0 0 1 1 1 1 
	1 1 1 1 0 0 0 0 0 0 0 1 1 1 1 
	0 0 0 0 0 0 0 0 0 0 0 0 1 1 1 
====================================

STEP 18
    Block Positions: p1: [11,0], p2: [11,0]
    Block Control: None
    Move: Move.Right

	0 0 0 0 0 0 1 1 1 1 1 1 1 0 0 
	1 1 1 1 0 0 1 1 1 0 0 1 1 0 0 
	1 1 1 1 1 1 1 1 1 0 0 1 1 1 1 
	1 1 1 1 0 0 0 0 0 0 0 1 1 1 1 
	1 1 1 1 0 0 0 0 0 0 0 1 1 1 1 
	0 0 0 0 0 0 0 0 0 0 0 0 1 1 1 
====================================

STEP 19
    Block Positions: p1: [11,1], p2: [11,2]
    Block Control: None
    Move: Move.Down

	0 0 0 0 0 0 1 1 1 1 1 1 1 0 0 
	1 1 1 1 0 0 1 1 1 0 0 1 1 0 0 
	1 1 1 1 1 1 1 1 1 0 0 1 1 1 1 
	1 1 1 1 0 0 0 0 0 0 0 1 1 1 1 
	1 1 1 1 0 0 0 0 0 0 0 1 1 1 1 
	0 0 0 0 0 0 0 0 0 0 0 0 1 1 1 
====================================

STEP 20
    Block Positions: p1: [12,1], p2: [12,2]
    Block Control: None
    Move: Move.Right

	0 0 0 0 0 0 1 1 1 1 1 1 1 0 0 
	1 1 1 1 0 0 1 1 1 0 0 1 1 0 0 
	1 1 1 1 1 1 1 1 1 0 0 1 1 1 1 
	1 1 1 1 0 0 0 0 0 0 0 1 1 1 1 
	1 1 1 1 0 0 0 0 0 0 0 1 1 1 1 
	0 0 0 0 0 0 0 0 0 0 0 0 1 1 1 
====================================

STEP 21
    Block Positions: p1: [12,3], p2: [12,3]
    Block Control: None
    Move: Move.Down

	0 0 0 0 0 0 1 1 1 1 1 1 1 0 0 
	1 1 1 1 0 0 1 1 1 0 0 1 1 0 0 
	1 1 1 1 1 1 1 1 1 0 0 1 1 1 1 
	1 1 1 1 0 0 0 0 0 0 0 1 1 1 1 
	1 1 1 1 0 0 0 0 0 0 0 1 1 1 1 
	0 0 0 0 0 0 0 0 0 0 0 0 1 1 1 
====================================

STEP 22
    Block Positions: p1: [13,3], p2: [14,3]
    Block Control: None
    Move: Move.Right

	0 0 0 0 0 0 1 1 1 1 1 1 1 0 0 
	1 1 1 1 0 0 1 1 1 0 0 1 1 0 0 
	1 1 1 1 1 1 1 1 1 0 0 1 1 1 1 
	1 1 1 1 0 0 0 0 0 0 0 1 1 1 1 
	1 1 1 1 0 0 0 0 0 0 0 1 1 1 1 
	0 0 0 0 0 0 0 0 0 0 0 0 1 1 1 
====================================

STEP 23
    Block Positions: p1: [12,3], p2: [12,3]
    Block Control: None
    Move: Move.Left

	0 0 0 0 0 0 1 1 1 1 1 1 1 0 0 
	1 1 1 1 0 0 1 1 1 0 0 1 1 0 0 
	1 1 1 1 1 1 1 1 1 0 0 1 1 1 1 
	1 1 1 1 0 0 0 0 0 0 0 1 1 1 1 
	1 1 1 1 0 0 0 0 0 0 0 1 1 1 1 
	0 0 0 0 0 0 0 0 0 0 0 0 1 1 1 
====================================

STEP 24
    Block Positions: p1: [12,4], p2: [12,5]
    Block Control: None
    Move: Move.Down

	0 0 0 0 0 0 1 1 1 1 1 1 1 0 0 
	1 1 1 1 0 0 1 1 1 0 0 1 1 0 0 
	1 1 1 1 1 1 1 1 1 0 0 1 1 1 1 
	1 1 1 1 0 0 0 0 0 0 0 1 1 1 1 
	1 1 1 1 0 0 0 0 0 0 0 1 1 1 1 
	0 0 0 0 0 0 0 0 0 0 0 0 1 1 1 
====================================

STEP 25
    Block Positions: p1: [13,4], p2: [13,5]
    Block Control: None
    Move: Move.Right

	0 0 0 0 0 0 1 1 1 1 1 1 1 0 0 
	1 1 1 1 0 0 1 1 1 0 0 1 1 0 0 
	1 1 1 1 1 1 1 1 1 0 0 1 1 1 1 
	1 1 1 1 0 0 0 0 0 0 0 1 1 1 1 
	1 1 1 1 0 0 0 0 0 0 0 1 1 1 1 
	0 0 0 0 0 0 0 0 0 0 0 0 1 1 1 
====================================

STEP 26
    Block Positions: p1: [13,3], p2: [13,3]
    Block Control: None
    Move: Move.Up

	0 0 0 0 0 0 1 1 1 1 1 1 1 0 0 
	1 1 1 1 0 0 1 1 1 0 0 1 1 0 0 
	1 1 1 1 1 1 1 1 1 0 0 1 1 1 1 
	1 1 1 1 0 0 0 0 0 0 0 1 1 1 1 
	1 1 1 1 0 0 0 0 0 0 0 1 1 1 1 
	0 0 0 0 0 0 0 0 0 0 0 0 1 1 1 
====================================
